MAP 6 4 3\n
AAA AAA AAA AAA AAA AAA\n
AAA AAA AAA AAA AAA AAA\n
AAA AAA AAA AAA AAA AAA\n
AAA AAA AAA AAA AAA AAA\n
\n
AAA AAA AAA AAA AAA AAA\n
AAA AAA AAA D// AAA AAA\n
AAA AAA AAA D// AAA AAA\n
AAA AAA AAA AAA AAA AAA\n
\n
AAA AAA AAA AAA AAA AAA\n
AAA AAA AAA D// AAA AAA\n
AAA AAA AAA D// AAA AAA\n
AAA AAA AAA AAA AAA A//\n
ENDMAP\n
START 0 0 0\n

A// = Arrivée
B// = Asteroide
C// = Nébulseuse
D// = Nuages Magnétique
E// - F// - G// - H// = Checkpoint