MAP 3 3 3
D// D// C//
C// AAA C//
AAA B// AAA

D// C// AAA
AAA C// AAA
AAA AAA D//

AAA AAA D//
C// AAA AAA
B// A// A//
ENDMAP
START 0 2 0