MAP 5 5 5
AAA AAA AAA AAA AAA
AAA AAA AAA AAA AAA
AAA AAA AAA E// AAA
AAA AAA AAA F// AAA
AAA AAA AAA AAA AAA

AAA AAA A// AAA AAA
AAA AAA AAA AAA AAA
AAA AAA AAA AAA AAA
AAA AAA AAA AAA AAA
B// AAA AAA AAA AAA

AAA AAA AAA AAA AAA
AAA AAA AAA AAA AAA
AAA AAA AAA AAA AAA
AAA AAA AAA AAA AAA
AAA AAA AAA AAA AAA

AAA AAA AAA AAA AAA
B// AAA AAA AAA AAA
AAA AAA AAA AAA AAA
AAA A// AAA AAA AAA
AAA AAA AAA AAA G//

AAA AAA AAA AAA AAA
AAA AAA H// AAA D//
AAA AAA AAA AAA AAA
AAA AAA AAA AAA AAA
AAA AAA AAA C// AAA
ENDMAP
START 1 1 2