MAP 4 4 4
AAA AAA AAA AAA
F// AAA AAA B//
AAA D// AAA AAA
AAA AAA AAA AAA

AAA AAA H// AAA
AAA AAA AAA AAA
AAA AAA AAA AAA
AAA AAA AAA AAA

AAA AAA AAA AAA
AAA AAA AAA AAA
G// AAA AAA C//
C// A// AAA AAA

A// AAA AAA AAA
AAA AAA B// E//
A// AAA AAA AAA
A// AAA AAA AAA
ENDMAP
START 1 2 2