MAP 6 5 6
AAA D// AAA AAA AAA AAA
AAA AAA AAA AAA AAA AAA
AAA D// AAA AAA AAA A//
AAA AAA AAA AAA AAA AAA
AAA AAA F// AAA AAA AAA

B// AAA AAA AAA AAA AAA
AAA AAA AAA AAA AAA AAA
AAA AAA AAA AAA B// C//
AAA AAA AAA AAA AAA AAA
AAA AAA AAA B// AAA AAA

AAA AAA AAA AAA AAA AAA
AAA AAA B// AAA AAA C//
AAA AAA AAA AAA AAA AAA
AAA AAA AAA C// AAA AAA
AAA AAA AAA AAA AAA AAA

AAA AAA AAA AAA AAA AAA
AAA AAA AAA C// D// AAA
D// AAA AAA AAA B// AAA
G// AAA AAA AAA AAA AAA
AAA AAA AAA AAA D// AAA

AAA AAA AAA AAA AAA AAA
AAA AAA D// AAA C// AAA
AAA AAA AAA D// AAA AAA
H// AAA AAA AAA AAA AAA
AAA AAA AAA AAA AAA AAA

AAA AAA B// AAA AAA AAA
AAA AAA AAA AAA AAA AAA
AAA AAA AAA AAA E// AAA
AAA AAA AAA AAA AAA AAA
AAA AAA AAA D// AAA AAA
ENDMAP
START 5 4 5