MAP 3 3 3
AAA AAA AAA
AAA AAA AAA
AAA AAA AAA

AAA E// C//
AAA AAA AAA
C// D// B//

AAA AAA A//
B// AAA C//
C// AAA F//
ENDMAP
START 2 1 1