MAP 4 4 3
AAA C// AAA AAA
AAA AAA AAA D//
AAA AAA AAA F//
AAA AAA AAA AAA

AAA D// AAA AAA
AAA AAA B// AAA
B// AAA C// AAA
AAA AAA AAA C//

AAA AAA AAA AAA
AAA E// D// AAA
B// A// AAA AAA
AAA AAA G// D//
ENDMAP
START 3 1 0