MAP 6 6 6
AAA AAA AAA AAA AAA AAA
AAA AAA AAA AAA AAA AAA
AAA AAA AAA AAA AAA AAA
AAA AAA AAA AAA AAA AAA
AAA AAA AAA AAA AAA AAA
AAA AAA AAA AAA AAA AAA

AAA AAA A// F// AAA AAA
A// AAA AAA AAA AAA AAA
AAA AAA AAA D// AAA B//
AAA AAA AAA AAA AAA AAA
AAA AAA AAA AAA AAA AAA
AAA AAA AAA AAA AAA AAA

A// AAA AAA AAA AAA AAA
AAA AAA AAA AAA AAA AAA
AAA AAA AAA D// AAA E//
AAA AAA AAA AAA AAA AAA
AAA AAA AAA AAA AAA AAA
D// AAA AAA AAA AAA AAA

AAA AAA AAA AAA AAA AAA
AAA AAA AAA AAA AAA AAA
D// AAA AAA AAA AAA AAA
AAA AAA AAA A// AAA AAA
AAA AAA AAA C// AAA AAA
AAA AAA AAA AAA AAA AAA

AAA AAA AAA AAA AAA AAA
AAA AAA AAA AAA AAA AAA
AAA AAA AAA AAA AAA AAA
AAA AAA AAA AAA AAA AAA
AAA AAA AAA AAA AAA AAA
AAA AAA AAA AAA AAA AAA

AAA AAA AAA AAA AAA AAA
AAA AAA AAA AAA AAA AAA
AAA AAA AAA AAA AAA AAA
AAA AAA AAA AAA AAA AAA
AAA B// AAA AAA AAA AAA
AAA AAA AAA C// AAA AAA
ENDMAP
START 0 0 0