MAP 4 4 4
AAA AAA AAA AAA
AAA AAA AAA AAA
AAA AAA AAA F//
AAA AAA AAA AAA

AAA AAA AAA AAA
AAA AAA AAA D//
AAA AAA AAA AAA
H// AAA AAA AAA

AAA A// AAA AAA
C// AAA AAA AAA
AAA AAA AAA AAA
AAA G// AAA AAA

AAA E// AAA AAA
AAA AAA AAA AAA
B// AAA AAA AAA
AAA AAA AAA AAA
ENDMAP
START 2 2 2