MAP 3 3 3
AAA D// E//
AAA B// AAA
AAA D// AAA

C// F// A//
AAA AAA A//
AAA B// AAA

D// AAA AAA
AAA AAA C//
D// AAA A//
ENDMAP
START 1 2 2