MAP 4 4 3
AAA AAA AAA B//
C// AAA AAA A//
B// AAA D// B//
AAA AAA AAA D//

D// AAA AAA D//
D// AAA AAA B//
D// A// C// AAA
AAA AAA AAA AAA

C// F// A// AAA
AAA C// AAA E//
G// AAA AAA AAA
C// AAA A// AAA
ENDMAP
START 1 2 0