MAP 3 4 3
AAA AAA AAA
D// AAA C//
C// D// AAA
AAA D// AAA

AAA B// AAA
B// D// C//
D// D// AAA
AAA AAA A//

E// AAA A//
A// AAA AAA
AAA B// C//
D// B// AAA
ENDMAP
START 0 2 0