MAP 4 4 4
B// AAA D// AAA
B// AAA AAA AAA
D// AAA AAA AAA
AAA AAA C// C//

AAA AAA B// C//
AAA AAA A// C//
AAA C// AAA D//
AAA AAA AAA AAA

AAA AAA AAA AAA
A// AAA AAA AAA
D// AAA C// B//
AAA A// AAA C//

AAA AAA C// A//
AAA AAA C// AAA
AAA AAA AAA AAA
AAA AAA AAA AAA
ENDMAP
START 1 0 2