MAP 4 4 4
AAA D// AAA AAA
E// AAA D// AAA
AAA AAA AAA AAA
AAA AAA AAA AAA

AAA AAA AAA AAA
AAA AAA AAA C//
AAA AAA AAA A//
C// AAA AAA AAA

AAA A// AAA F//
A// AAA AAA AAA
AAA AAA AAA AAA
AAA AAA AAA AAA

AAA AAA AAA AAA
B// AAA AAA C//
AAA AAA AAA B//
AAA AAA AAA A//
ENDMAP
START 0 2 1