MAP 3 3 3
AAA AAA AAA
AAA C// AAA
AAA E// AAA

A// B// AAA
AAA AAA AAA
AAA AAA AAA

AAA AAA AAA
AAA AAA AAA
AAA AAA F//
ENDMAP
START 2 0 2