MAP 3 3 3
AAA C// D//
B// AAA AAA
B// AAA AAA

E// B// AAA
D// D// AAA
G// AAA B//

AAA A// B//
D// F// AAA
AAA AAA D//
ENDMAP
START 1 1 2