MAP 4 3 3
C// C// AAA A//
AAA AAA AAA AAA
C// A// AAA AAA

AAA AAA AAA AAA
AAA AAA AAA AAA
AAA AAA A// AAA

AAA AAA AAA AAA
AAA AAA A// E//
C// AAA AAA AAA
ENDMAP
START 2 2 0