MAP 7 7 7
AAA AAA AAA AAA D// AAA AAA
AAA AAA AAA AAA AAA AAA AAA
AAA AAA C// C// AAA AAA A//
AAA AAA AAA AAA AAA AAA AAA
AAA AAA AAA AAA AAA AAA AAA
AAA AAA AAA AAA AAA AAA AAA
AAA AAA AAA AAA B// AAA AAA

AAA AAA AAA AAA C// G// AAA
E// AAA AAA C// AAA AAA AAA
AAA AAA AAA AAA AAA AAA AAA
AAA AAA AAA AAA AAA AAA AAA
AAA AAA AAA AAA AAA AAA AAA
AAA AAA AAA AAA AAA AAA AAA
AAA AAA AAA B// AAA AAA AAA

AAA AAA AAA AAA AAA AAA AAA
AAA AAA AAA AAA AAA AAA AAA
AAA AAA AAA AAA AAA AAA AAA
AAA AAA AAA AAA AAA AAA AAA
AAA AAA AAA AAA AAA AAA AAA
AAA AAA AAA AAA AAA AAA AAA
AAA AAA AAA AAA AAA AAA AAA

AAA AAA AAA AAA AAA AAA AAA
AAA AAA AAA AAA AAA AAA AAA
AAA AAA AAA AAA AAA AAA AAA
AAA AAA AAA AAA AAA AAA AAA
AAA AAA AAA AAA AAA AAA AAA
AAA AAA AAA AAA AAA AAA AAA
AAA AAA AAA AAA AAA AAA AAA

AAA AAA AAA AAA AAA AAA AAA
AAA AAA AAA AAA AAA AAA AAA
AAA AAA AAA AAA AAA AAA AAA
AAA AAA AAA AAA AAA AAA AAA
AAA AAA AAA AAA AAA AAA AAA
AAA AAA AAA AAA AAA F// AAA
AAA AAA AAA AAA AAA AAA AAA

AAA AAA AAA AAA AAA AAA AAA
AAA AAA AAA AAA AAA AAA AAA
AAA AAA AAA AAA AAA AAA AAA
AAA AAA AAA AAA AAA AAA AAA
AAA AAA AAA AAA AAA AAA AAA
AAA AAA AAA AAA AAA AAA AAA
AAA AAA AAA AAA AAA AAA AAA

AAA AAA AAA AAA AAA AAA AAA
AAA AAA B// AAA AAA AAA AAA
AAA AAA AAA AAA AAA AAA AAA
AAA AAA AAA AAA AAA AAA AAA
AAA AAA AAA AAA AAA AAA AAA
AAA AAA AAA AAA AAA AAA AAA
AAA AAA AAA AAA AAA AAA AAA
ENDMAP
START 5 0 6